*********
*.......*
*.**S**.*
*.......*
*.......*
*..***..*
*.......*
***.***.*
***.***..
**...****