*********
*.......*
*.**S**.*
*.......*
*.......*
*..***..*
*.......*
*******.*
*******..
**...****